||||||||||||
|..........|
|...E......|
|..........|
|..........|
|..........|
|..........|
|..........|
|.S........|
|..........|
|..........|
||||||||||||