||||||||||||
|..........|
|.X.EXXXX.X|
|...X......|
|.XXX..X...|
|...XX.XXX.|
|XXXX.....X|
|.X.....X..|
|.SXXX.X...|
|.....X....|
|..........|
||||||||||||