||||||||||||||||||||||
|....................|
|.X..............E...|
|....................|
|.XXX................|
|...X................|
|.XXX................|
|.X..................|
|.S..................|
|.....X..............|
|....................|
||||||||||||||||||||||