||||||||||||||||||||||
|....................|
|.X.............XE...|
|...............XX...|
|.XXX...........XXX..|
|...X................|
|.XXXXX..............|
|.X...X..............|
|.S...X..............|
|.....X..............|
|....................|
||||||||||||||||||||||